"a" = (/obj/destructable/wall,/turf,/area)
"b" = (/turf/floor,/area/dark)
"c" = (/obj/destructable/wall,/turf,/area/dark)
"d" = (/turf/floor_creepy,/area/dark)
"e" = (/turf/start,/area/dark)
"f" = (/obj/destructable/door,/turf,/area/dark)
"g" = (/mob/Enemies/Evil_Kid,/turf/floor_creepy,/area/dark)
"h" = (/mob/Punching_Bag,/turf/floor,/area/dark)
"i" = (/obj/destructable/bedbot,/turf/floor,/area/dark)
"j" = (/obj/destructable/bed,/turf/floor,/area/dark)

(1,1,1) = {"
aaaaaaaaaaaaaaaaaaaaaaaaaaaaaa
addddddddcbbbbbbbbbbbbbbbbbbba
adgggggddcbbcccccbbbbbbbbbbbba
adgggggddcbbcbbbcbbbbbbbbbbbba
adgggggddcbbcbbbcbbbbbbbbbbbba
adgggggddcbbcbbbcbbbbbbbbbbbba
adgggggddcbbcbbbcbbbbbbbbbbbba
addddddddccccbbbcbbbbbbbbbbbba
addddddddfbbbbbbcbbbbbbbbbbbba
acccccccccbbbbbbcbbbbbbbbbbbba
abbbbbbbbbbccccccbbbbbbbbbbbba
abbbccccccccbbbbbbbbbbbbbbbbba
abbbcbbbbbbbbbbbbbbbbbbbbbbbba
abbbcbbbbbbbbbbbbbbbbbbbbbbbba
abbbcbbbbbbbbbbbbbbbbbbbbbbbba
abbbcbbbbbbbbbbbbbbbbbbbbbbbba
abbbcccccccccccccbbbbbbbbbbbba
abbbbbbbbbbbbbbbcbbbbbbbbbbbba
abbbbbbbbbbbbbbbcbbbbbbbbbbbha
abbbbbbbbbbbbbbbcbbbbbbbbbbbba
abbbbbbbbbbbbbbbcbbbbbbbbbbbba
abcccccccccccccccbbbbbbbbbbbba
abcbbbcbbbbbbbbbbbbbbbbbbbbbja
abcbcbcbcbbbbbbbbbbbbbbbbbbbia
abcbcbcbcbbbbbbbbbbbbbbbbbbbba
abcbcbcbcbbbbbbbbbbbbbbbbbbbba
abcbcbcbcbbbbbbbbbbbbbbbbbbbba
abcbcbcbcbbbbbbbbbbbbbbbbbbbba
abbbcbbbcbbbbbbbbbbbbbbbbbbbea
aaaaaaaaaaaaaaaaaaaaaaaaaaaaaa
"}
