"a" = (/turf/wall,/area)
"b" = (/turf/floor,/area/dark)
"c" = (/turf/start,/area/dark)
"d" = (/obj/poison,/turf/floor,/area/dark)

(1,1,1) = {"
aaaaaaaaaa
abbbbbbbba
abbbbbbbba
abbbbbbbba
abbbbbbbba
abbbcdbbba
abbbbbbbba
abbbbbbbba
abbbbbbbba
aaaaaaaaaa
"}
