"a" = (/turf,/area)
"b" = (/turf/wall,/area)
"c" = (/turf/floor,/area)

(1,1,1) = {"
aaaaaaaaaaaaaaaaaaaaaaaaaaabbbbbbbbbbbbbbbbbbbbbbbbbbbbbbbbb
aaaaaaaaaaaaaaaaaaaaaaaaaaaaaaaaaaccccccccccaaaaaaaaaaaaaaab
aaaaaaaaaaaaaaaaaaaaaaaaaaaaaaaaaaaaaaaaaaaaaaaaaaaaaaaaaaab
aaaaaaaaaaaaaaaaaaaaaaaaaaaaaaaaaaaaaaaaaaaaaaaaaaaaaaaaaaab
aaaaaaaaaaaaaaaaaaaaaaaaaaaaaaaaaaaaaaaaaaaaaaaaaaaaaaaaaaab
aaaaaaaaaaaaaaaaaaaaaaaaaaaaaaaaaaaaaaaaaaaaaaaaaaaaaaaaaaab
aaaaaaaaaaaaaaaaaaaaaaaaaaaaaaaaaaaaaaaaaaaaaaaaaaaaaaaaaaab
aaaaaaaaaaaaaaaaaaaaaaaaaaaaaaaaaaaaaaaaaaaaaaaaaaaaaaaaaaab
aaaaaaaaaaaaaaaaaaaaaaaaaaaaaaaaaaaaaaaaaaaaaaaaaaaaaaaaaaab
aaaaaaaaaaaaaaaaaaaaaaaaaaaaaaaaaaaaaaaaaaaaaaaaaaaaaaaaaaab
aaaaaaaaaaaaaaaaaaaaaaaaaaaaaaaaaaaaaaaaaaaaaaaaaaaaaaaaaaab
aaaaaaaaaaaaaaaaaaaaaaaaaaaaaaaaaaaaaaaaaaaaaaaaaaaaaaaaaaab
aaaaaaaaaaaaaaaaaaaaaaaaaaaaaaaaaaaaaaaaaaaaaaaaaaaaaaaaaaab
aaaaaaaaaaaaaaaaaaaaaaaaaaaaaaaaaaaaaaaaaaaaaaaaaaaaaaaaaaab
aaaaaaaaaaaaaaaaaaaaaaaaaaaaaaaaaaaaaaaaaaaaaaaaaaaaaaaaaaab
aaaaaaaaaaaaaaaaaaaaaaaaaaaaaaaaaaaaaaaaaaaaaaaaaaaaaaaaaaab
aaaaaaaaaaaaaaaaaaaaaaaaaaaaaaaaaaaaaaaaaaaaaaaaaaaaaaaaaaab
aaaaaaaaaaaaaaaaaaaaaaaaaaaaaaaaaaaaaaaaaaaaaaaaaaaaaaaaaaab
aaaaaaaaaaaaaaaaaaaaaaaaaaaaaaaaaaaaaaaaaaaaaaaaaaaaaaaaaaab
aaaaaaaaaaaaaaaaaaaaaaaaaaaaaaaaaaaaaaaaaaaaaaaaaaaaaaaaaaab
aaaaaaaaaaaaaaaaaaaaaaaaaaaaaaaaaaaaaaaaaaaaaaaaaaaaaaaaaaab
aaaaaaaaaaaaaaaaaaaaaaaaaaaaaaaaaaaaaaaaaaaaaaaaaaaaaaaaaaab
aaaaaaaaaaaaaaaaaaaaaaaaaaaaaaaaaaaaaaaaaaaaaaaaaaaaaaaaaaab
aaaaaaaaaaaaaaaaaaaaaaaaaaaaaaaaaaaaaaaaaaaaaaaaaaaaaaaaaaab
aaaaaaaaaaaaaaaaaaaaaaaaaaaaaaaaaaaaaaaaaaaaaaaaaaaaaaaaaaab
aaaaaaaaaaaaaaaaaaaaaaaaaaaaaaaaaaaaaaaaaaaaaaaaaaaaaaaaaaab
cccccccccccccccccccccccccccccccccccccccccccccccccccaaaaaaaab
cccccccccccccccccccccccccccccccccccccccccccccccccccaaaaaaaab
cccccccccccccccccccccccccccccccccccccccccccccccccccaaaaaaaab
cccccccccccccccccccccccccccccccccccccccccccccccccccaaaaaaaab
cccccccccccccccccccccccccccccccccccccccccccccccccccaaaaaaaab
cccccccccccccccccccccccccccccccccccccccccccccccccccaaaaaaaab
cccccccccccccccccccccccccccccccccccccccccccccccccccaaaaaaaab
cccccccccccccccccccccccccccccccccccccccccccccccccccaaaaaaaab
cccccccccccccccccccccccccccccccccccccccccccccccccccaaaaaaaab
cccccccccccccccccccccccccccccccccccccccccccccccccccaaaaaaaab
cccccccccccccccccccccccccccccccccccccccccccccccccccaaaaaaaab
cccccccccccccccccccccccccccccccccccccccccccccccccccaaaaaaaab
cccccccccccccccccccccccccccccccccccccccccccccccccccaaaaaaaab
cccccccccccccccccccccccccccccccccccccccccccccccccccaaaaaaaab
cccccccccccccccccccccccccccccccccccccccccccccccccccaaaaaaaab
cccccccccccccccccccccccccccccccccccccccccccccccccccaaaaaaaab
cccccccccccccccccccccccccccccccccccccccccccccccccccaaaaaaaab
cccccccccccccccccccccccccccccccccccccccccccccccccccaaaaaaaab
cccccccccccccccccccccccccccccccccccccccccccccccccccaaaaaaaab
cccccccccccccccccccccccccccccccccccccccccccccccccccaaaaaaaab
cccccccccccccccccccccccccccccccccccccccccccccccccccaaaaaaaab
cccccccccccccccccccccccccccccccccccccccccccccccccccaaaaaaaab
cccccccccccccccccccccccccccccccccccccccccccccccccccaaaaaaaab
cccccccccccccccccccccccccccccccccccccccccccccccccccaaaaaaaab
cccccccccccccccccccccccccccccccccccccccccccccccccccaaaaaaaab
cccccccccccccccccccccccccccccccccccccccccccccccccccaaaaaaaab
cccccccccccccccccccccccccccccccccccccccccccccccccccaaaaaaaab
cccccccccccccccccccccccccccccccccccccccccccccccccccaaaaaaaab
cccccccccccccccccccccccccccccccccccccccccccccccccccaaaaaaaab
cccccccccccccccccccccccccccccccccccccccccccccccccccaaaaaaaab
cccccccccccccccccccccccccccccccccccccccccccccccccccaaaaaaaab
cccccccccccccccccccccccccccccccccccccccccccccccccccaaaaaaaab
cccccccccccccccccccccccccccccccccccccccccccccccccccaaaaaaaab
cccccccccccccccccccccccccccccccccccccccccccccccccccaaaaaaaab
"}
